MapName	TabFileName
10人英雄荻花圣殿	10RenYingXiongDiHuaShengDian.tab
10人烛龙殿	10RenZhuLongDian.tab
25人龙渊泽	25RenLongYuanZe.tab
25人普通持国天王殿	25RenPuTongChiGuoTianWangDian.tab
25人普通荻花圣殿	25RenPuTongDiHuaShengDian.tab
25人普通宫中神武遗迹	25RenPuTongGongZhongShenWuYiJi.tab
25人英雄荻花圣殿	25RenYingXiongDiHuaShengDian.tab
25人英雄会战唐门	25RenYingXiongHuiZhanTangMen.tab
25人英雄龙渊泽	25RenYingXiongLongYuanZe.tab
25人英雄烛龙殿	25RenYingXiongZhuLongDian.tab
70级野外阵营pvpNPC	70JiYeWaiZhenYingpvpNPC.tab
80安史之乱天策	80AnShiZhiLuanTianCe.tab
80橙武任务	80ChengWuRenWu.tab
80级属地据点NPC	80JiShuDiJuDianNPC.tab
80小橙武任务	80XiaoChengWuRenWu.tab
ACT_2013年夜饭	ACT_2013NianYeFan.tab
Act_安史之乱预热	Act_AnShiZhiLuanYuRe.tab
ACT_苍云预热	ACT_CangYunYuRe.tab
ACT_长安内城	ACT_ChangAnNeiCheng.tab
ACT_峰值活动	ACT_FengZhiHuoDong.tab
ACT_令狐伤的进击	ACT_LingHuShangDeJinJi.tab
Act_流寇入侵	Act_LiuKouRuQin.tab
Act_门派入侵	Act_MenPaiRuQin.tab
ACT_明教预热	ACT_MingJiaoYuRe.tab
Act_挑战策划	Act_TiaoZhanCeHua.tab
ACT_系统活动	ACT_XiTongHuoDong.tab
ACT_血战天策预热	ACT_XueZhanTianCeYuRe.tab
ACT_押镖活动	ACT_YaBiaoHuoDong.tab
ACT_一传十	ACT_YiChuanShi.tab
Act_幽陵劫潮	Act_YouLingJieChao.tab
Act_元宵节	Act_YuanXiaoJie.tab
Act_运营活动通用	Act_YunYingHuoDongTongYong.tab
ACT_真功夫	ACT_ZhenGongFu.tab
安史之乱枫华谷	AnShiZhiLuanFengHuaGu.tab
安史之乱_长安	AnShiZhiLuan_ChangAn.tab
安史之乱_洛阳	AnShiZhiLuan_LuoYang.tab
百草园	BaiCaoYuan.tab
白龙口PQ	BaiLongKouPQ.tab
白龙口任务敌对NPC	BaiLongKouRenWuDiDuiNPC.tab
白龙口任务友善NPC	BaiLongKouRenWuYouShanNPC.tab
巴陵敌对NPC	BaLingDiDuiNPC.tab
巴陵友善NPC	BaLingYouShanNPC.tab
帮会	BangHui.tab
帮会家园	BangHuiJiaYuan.tab
帮会擂台	BangHuiLeiTai.tab
帮会天工树三期	BangHuiTianGongShuSanQi.tab
帮会田园	BangHuiTianYuan.tab
帮会约战	BangHuiYueZhan.tab
帮会约战擂台	BangHuiYueZhanLeiTai.tab
北邙山	BeiMangShan.tab
逼婚GWW	BiHunGWW.tab
不告诉你	BuGaoSuNi.tab
藏剑山庄	CangJianShanZhuang.tab
苍山洱海	CangShanErHai.tab
苍山洱海北部战斗NPC	CangShanErHaiBeiBuZhanDouNPC.tab
苍山洱海表现NPC	CangShanErHaiBiaoXianNPC.tab
苍山洱海崇圣寺	CangShanErHaiChongShengSi.tab
苍山洱海大理军营	CangShanErHaiDaLiJunYing.tab
苍山洱海敌对飞豹军	CangShanErHaiDiDuiFeiBaoJun.tab
苍山洱海敌对飞虎军	CangShanErHaiDiDuiFeiHuJun.tab
苍山洱海敌对飞熊军	CangShanErHaiDiDuiFeiXiongJun.tab
苍山洱海敌对NPC	CangShanErHaiDiDuiNPC.tab
苍山洱海动物NPC	CangShanErHaiDongWuNPC.tab
苍山洱海洱月村	CangShanErHaiErYueCun.tab
苍山洱海飞象军	CangShanErHaiFeiXiangJun.tab
苍山洱海风城	CangShanErHaiFengCheng.tab
苍山洱海功能NPC	CangShanErHaiGongNengNPC.tab
苍山洱海马场NPC	CangShanErHaiMaChangNPC.tab
苍山洱海南诏皇宫	CangShanErHaiNanZhaoHuangGong.tab
苍山洱海南诏皇宫	CangShanErHaiNanZuoHuangGong.tab
苍山洱海任务NPC	CangShanErHaiRenWuNPC.tab
苍山洱海主线剧情	CangShanErHaiZhuXianJuQing.tab
苍云_血誓后	CangYun_XueShiHou.tab
苍云_血誓前	CangYun_XueShiQian.tab
测试	CeShi.tab
长安城	ChangAnCheng.tab
长安敌对npc	ChangAnDiDuinpc.tab
长安友善npc	ChangAnYouShannpc.tab
成都	ChengDu.tab
成都表现特效	ChengDuBiaoXianTeXiao.tab
成都纯表现类NPC	ChengDuChunBiaoXianLeiNPC.tab
成都敌对	ChengDuDiDui.tab
成都动物	ChengDuDongWu.tab
成都功能NPC	ChengDuGongNengNPC.tab
成都功能区表现	ChengDuGongNengQuBiaoXian.tab
成都剑圣表现	ChengDuJianShengBiaoXian.tab
成都擂台	ChengDuLeiTai.tab
成都判案任务	ChengDuPanAnRenWu.tab
成都PQ	ChengDuPQ.tab
成都任务用补充NPC	ChengDuRenWuYongBuChongNPC.tab
成都狩猎表现	ChengDuShouLieBiaoXian.tab
成都围攻表现	ChengDuWeiGongBiaoXian.tab
成都友善	ChengDuYouShan.tab
成就	ChengJiu.tab
持国天王殿	ChiGuoTianWangDian.tab
持国天王殿_回忆录	ChiGuoTianWangDian_HuiYiLu.tab
春明门	ChunMingMen.tab
纯阳	ChunYang.tab
村镇城表现NPC模版	CunZhenChengBiaoXianNPCMoBan.tab
大明宫	DaMingGong.tab
稻香村(副本)	DaoXiangCun(FuBen).tab
大唐监狱	DaTangJianYu.tab
电影专用	DianYingZhuanYong.tab
荻花洞窟	DiHuaDongKu.tab
荻花宫	DiHuaGong.tab
荻花宫后山	DiHuaGongHouShan.tab
荻花圣殿	DiHuaShengDian.tab
低级光明顶秘道	DiJiGuangMingDingMiDao.tab
低级唐门密室	DiJiTangMenMiShi.tab
动态阵法	DongTaiZhenFa.tab
动物世界	DongWuShiJie.tab
动物园	DongWuYuan.tab
毒神殿	DuShenDian.tab
恶人谷	ERenGu.tab
恶人谷敌对	ERenGuDiDui.tab
反外挂NPC	FanWaiGuaNPC.tab
法王窟	FaWangKu.tab
法王窟表现补充	FaWangKuBiaoXianBuChong.tab
法王窟英雄	FaWangKuYingXiong.tab
非跟宠充值促销道具	FeiGenChongChongZhiCuXiaoDaoJu.tab
枫桦谷	FengHuaGu.tab
枫华谷和洛道野外boss	FengHuaGuHeLuoDaoYeWaiboss.tab
风雪稻香村	FengXueDaoXiangCun.tab
风雨稻香村(英雄)	FengYuDaoXiangCun(YingXiong).tab
副本重复任务	FuBenZhongFuRenWu.tab
丐帮	GaiBang.tab
高老庄	GaoLaoZhuang.tab
功能通用NPC	GongNengTongYongNPC.tab
宫中神武遗迹	GongZhongShenWuYiJi.tab
光明顶秘道	GuangMingDingMiDao.tab
浩气盟敌对	HaoQiMengDiDui.tab
浩气盟功能	HaoQiMengGongNeng.tab
浩气盟友善	HaoQiMengYouShan.tab
黑龙沼敌对NPC	HeiLongZhaoDiDuiNPC.tab
黑龙沼动物表现	HeiLongZhaoDongWuBiaoXian.tab
黑龙沼剧情表现用NPC	HeiLongZhaoJuQingBiaoXianYongNPC.tab
黑龙沼PQ	HeiLongZhaoPQ.tab
黑龙沼生活技能NPC	HeiLongZhaoShengHuoJiNengNPC.tab
黑龙沼友善NPC	HeiLongZhaoYouShanNPC.tab
黑龙沼阵营NPC	HeiLongZhaoZhenYingNPC.tab
黑龙沼重点表现NPC	HeiLongZhaoZhongDianBiaoXianNPC.tab
红衣教模板	HongYiJiaoMoBan.tab
华清宫	HuaQingGong.tab
华清宫回忆录	HuaQingGongHuiYiLu.tab
回归新掌门	HuiGuiXinZhangMen.tab
会战唐门	HuiZhanTangMen.tab
活动	HuoDong.tab
活动通用NPC	HuoDongTongYongNPC.tab
剑冢	JianZhong.tab
节日	JieRi.tab
节日春节	JieRiChunJie.tab
节日冬至	JieRiDongZhi.tab
节日儿童节	JieRiErTongJie.tab
节日清明	JieRiQingMing.tab
节日七夕	JieRiQiXi.tab
节日元旦	JieRiYuanDan.tab
节日中秋	JieRiZhongQiu.tab
节日重阳	JieRiZhongYang.tab
寂灭厅	JiMieTing.tab
技能	JiNeng.tab
金水镇	JinShuiZhen.tab
集群刷马	JiQunShuaMa.tab
九宫棋谷	JiuGongQiGu.tab
科举考试	KeJuKaoShi.tab
空雾峰	KongWuFeng.tab
寇岛	KouDao.tab
困龙岭	KunLongLing.tab
昆仑	KunLun.tab
冷香丘	LengXiangQiu.tab
连珠寨	LianZhuZhai.tab
灵霄峡	LingXiaoXia.tab
流离岛	LiuLiDao.tab
龙门荒漠	LongMenHuangMo.tab
龙渊泽	LongYuanZe.tab
洛道	LuoDao.tab
洛阳	LuoYang.tab
洛阳城	LuoYangCheng.tab
马嵬驿	MaWeiYi.tab
美人图	MeiRenTu.tab
美人图活动	MeiRenTuHuoDong.tab
门派活动	MenPaiHuoDong.tab
明教	MingJiao.tab
迷仙引	MiXianYin.tab
墨家密殿	MoJiaMiDian.tab
南屏山	NanPingShan.tab
南诏皇宫	NanZhaoHuangGong.tab
南诏皇宫	NanZuoHuangGong.tab
npcqnpc	npcqnpc.tab
PQ BOSS	PQ BOSS.tab
普通雁门关之役	PuTongYanMenGuanZhiYi.tab
普通一线天	PuTongYiXianTian.tab
前线支援	QianXianZhiYuan.tab
秦皇陵	QinHuangLing.tab
齐物阁	QiWuGe.tab
七秀	QiXiu.tab
瞿塘峡	QuTangXia.tab
瞿塘峡表现NPC	QuTangXiaBiaoXianNPC.tab
瞿塘峡敌对	QuTangXiaDiDui.tab
日轮山城	RiLunShanCheng.tab
融天岭补充	RongTianLingBuChong.tab
融天岭功能npc	RongTianLingGongNengnpc.tab
融天岭怪物npc	RongTianLingGuaiWunpc.tab
融天岭接交任务npc	RongTianLingJieJiaoRenWunpc.tab
融天岭PQ	RongTianLingPQ.tab
融天岭任务表现npc	RongTianLingRenWuBiaoXiannpc.tab
融天岭阵法表现	RongTianLingZhenFaBiaoXian.tab
赛马活动	SaiMaHuoDong.tab
三国古战场	SanGuoGuZhanChang.tab
商店	ShangDian.tab
商店NPC模板	ShangDianNPCMoBan.tab
少林	ShaoLin.tab
神策军模板	ShenCeJunMoBan.tab
生活技能模板	ShengHuoJiNengMoBan.tab
生活技艺	ShengHuoJiYi.tab
声望	ShengWang.tab
神农洇	ShenNongYin.tab
十二连环坞模板	ShiErLianHuanWuMoBan.tab
世界活动	ShiJieHuoDong.tab
世界任务	ShiJieRenWu.tab
试炼之境	ShiLianZhiJing.tab
师徒任务	ShiTuRenWu.tab
守株围场_打猎	ShouZhuWeiChang_DaLie.tab
丝绸之路	SiChouZhiLu.tab
太原	TaiYuan.tab
太原之战_夜守孤城	TaiYuanZhiZhan_YeShouGuCheng.tab
太原之战_逐虎驱狼	TaiYuanZhiZhan_ZhuHuQuLang.tab
唐门	TangMen.tab
唐门脚本及表现用NPC	TangMenJiaoBenJiBiaoXianYongNPC.tab
唐门密室	TangMenMiShi.tab
特殊武器任务	TeShuWuQiRenWu.tab
天策	TianCe.tab
天策场景功能NPC	TianCeChangJingGongNengNPC.tab
天工坊	TianGongFang.tab
天子峰	TianZiFeng.tab
提交单测试内容	TiJiaoDanCeShiNeiRong.tab
挖宝	WaBao.tab
万花谷	WanHuaGu.tab
万花脚本功能NPC	WanHuaJiaoBenGongNengNPC.tab
万甲园	WanJiaYuan.tab
五毒	WuDu.tab
五毒脚本任务表现NPC	WuDuJiaoBenRenWuBiaoXianNPC.tab
五毒资料片PQ	WuDuZiLiaoPianPQ.tab
无量宫	WuLiangGong.tab
无量山	WuLiangShan.tab
无量山纯表现	WuLiangShanChunBiaoXian.tab
无量山动物表现	WuLiangShanDongWuBiaoXian.tab
无量山怪物npc	WuLiangShanGuaiWunpc.tab
无量山花山节	WuLiangShanHuaShanJie.tab
无量山接交任务npc	WuLiangShanJieJiaoRenWunpc.tab
无量山PQ	WuLiangShanPQ.tab
无量山任务表现npc	WuLiangShanRenWuBiaoXiannpc.tab
无盐岛	WuYanDao.tab
陷空坳	XianKongAo.tab
仙踪林	XianZongLin.tab
小仙踪林	XiaoXianZongLin.tab
新手村	XinShouCun.tab
血战天策	XueZhanTianCe.tab
寻宝系统	XunBaoXiTong.tab
驯养系统宠物NPC跟随	XunYangXiTongChongWuNPCGenSui.tab
驯养系统宠物NPC预览补充	XunYangXiTongChongWuNPCYuLanBuChong.tab
驯养系统宠物NPC召唤	XunYangXiTongChongWuNPCZhaoHuan.tab
驯养系统宠物任务NPC	XunYangXiTongChongWuRenWuNPC.tab
驯养系统NPC表现	XunYangXiTongNPCBiaoXian.tab
驯养系统NPC事件	XunYangXiTongNPCShiJian.tab
驯养系统NPC野外	XunYangXiTongNPCYeWai.tab
驯养系统NPC召唤	XunYangXiTongNPCZhaoHuan.tab
扬州	YangZhou.tab
扬州城	YangZhouCheng.tab
雁门关之役	YanMenGuanZhiYi.tab
邀星坪	YaoXingPing.tab
野外场景日常boss	YeWaiChangJingRiChangboss.tab
一刀流模板	YiDaoLiuMoBan.tab
英雄北邙山三才阵	YingXiongBeiMangShanSanCaiZhen.tab
英雄持国回忆录	YingXiongChiGuoHuiYiLu.tab
英雄持国天王殿	YingXiongChiGuoTianWangDian.tab
英雄持国天王殿回忆录	YingXiongChiGuoTianWangDianHuiYiLu.tab
英雄大明宫	YingXiongDaMingGong.tab
英雄荻花洞窟	YingXiongDiHuaDongKu.tab
英雄荻花宫后山	YingXiongDiHuaGongHouShan.tab
英雄荻花宫前山	YingXiongDiHuaGongQianShan.tab
英雄毒神殿	YingXiongDuShenDian.tab
英雄风雪稻香村	YingXiongFengXueDaoXiangCun.tab
英雄宫中神武遗迹	YingXiongGongZhongShenWuYiJi.tab
英雄华清宫	YingXiongHuaQingGong.tab
英雄剑冢	YingXiongJianZhong.tab
英雄寂灭厅	YingXiongJiMieTing.tab
英雄空雾峰	YingXiongKongWuFeng.tab
英雄灵霄峡	YingXiongLingXiaoXia.tab
英雄流离岛	YingXiongLiuLiDao.tab
英雄龙渊泽	YingXiongLongYuanZe.tab
英雄南诏皇宫	YingXiongNanZhaoHuangGong.tab
英雄秦皇陵	YingXiongQinHuangLing.tab
英雄日轮山城	YingXiongRiLunShanCheng.tab
英雄太原之战_夜守孤城	YingXiongTaiYuanZhiZhan_YeShouGuCheng.tab
英雄太原之战_逐虎驱狼	YingXiongTaiYuanZhiZhan_ZhuHuQuLang.tab
英雄天工坊	YingXiongTianGongFang.tab
英雄天子峰	YingXiongTianZiFeng.tab
英雄无量宫	YingXiongWuLiangGong.tab
英雄无盐岛	YingXiongWuYanDao.tab
英雄仙踪林	YingXiongXianZongLin.tab
英雄血战天策	YingXiongXueZhanTianCe.tab
英雄一线天	YingXiongYiXianTian.tab
英雄战宝迦兰	YingXiongZhanBaoJiaLan.tab
英雄战宝军械库	YingXiongZhanBaoJunXieKu.tab
英雄珍珑棋谷	YingXiongZhenLongQiGu.tab
隐元追缉令	YinYuanZhuiJiLing.tab
云湖天池	YunHuTianChi.tab
载具	ZaiJu.tab
战宝迦兰	ZhanBaoJiaLan.tab
战宝迦兰任务	ZhanBaoJiaLanRenWu.tab
战宝军械库	ZhanBaoJunXieKu.tab
战斗通用NPC(大量)	ZhanDouTongYongNPC(DaLiang).tab
阵营攻防战改造	ZhenYingGongFangZhanGaiZao.tab
阵营活动首领	ZhenYingHuoDongShouLing.tab
阵营无监视首领	ZhenYingWuJianShiShouLing.tab
直城门	ZhiChengMen.tab
装备洗炼	ZhuangBeiXiLian.tab
状态机	ZhuangTaiJi.tab
主城茶馆	ZhuChengChaGuan.tab
主城木桩	ZhuChengMuZhuang.tab
烛龙殿10人	ZhuLongDian10Ren.tab
烛龙殿表现	ZhuLongDianBiaoXian.tab
逐鹿中原	ZhuLuZhongYuan.tab
_默认值	_MoRenZhi.tab
